.)......).
*..)..)..*
."".).."".
)..$..$...
*).$.)$.)*
.""$).$"".
#(#%(#%#(#
##(%@#%(##
(####(###(
##(###(###